#####__##_#####
i____________##
###_#_###___###
______###_#_###
_######__##__##
___________####
_###_####_#####
__##_##____####
####__####_____
##___##____###o
_#####_#_#__###
_#_###___##__##
_#_###_#####_##
_______#####__#
_##############
