___####_#######
_#__#___#___###
__#___#___#___#
#_###___#_#_#_#
#___#####___#_o
###_###########
###_________###
____#_#__###__#
####__#_______#
##____###_#####
#___##________#
####____#_##__#
_____#__#_###_#
_########_###_#
i__############